111111111111111111111111111111111111111
110C1000001000111000000C111100001C00101
111110010010001000001000C111100001C0001
10000001C01110P0000100000000000C0000011
100000010000111000000000001111110000001
1000C001000000000E0010000C00000C0000011
11111111111111111110000000C00000C000001
1000000000000000000000000000000000N0001
111111111111111111111111111111111111111