111111111111111111111
100000000000000000001
10000000000c000000001
1000000c0000000000001
100000000000000000001
111111111111111111111