111111111111111111111
100000000000000000001
1000C000000000E000001
10000000C00000P000001
100000000000000000001
1000C000000000E000001
10000000C00000C000001
100000000000000000001
111111111111111111111