111111111111111111111111111111111111111
11001000001000111000N00C111100001C00101
111110010010001000001000C111100001C0001
10000001C01110P0000100000000000C0000011
100000010000111000000000001111110000001
1000C00100000000E0010000C00000C00000111
11111111111111111110000000C00000C000001
10000000000000000000000000000000000N001
111111111111111111111111111111111111111