111111111111111111111111111111111111111
10000000001000000000000C111100001C00001
1000C0000010001000001000C111100001C0001
10000000C01110P00000100000000000C000001
100000000000100000000000001111110000001
1000C000000000E0000010000C00000C0000011
11111111111111111110000000C00000C000001
10000000000010000000100000C00000C000001
111111111111111111111111111111111111111